NCORIE=fiirxi
MSGNBQZSV=nytcmjzks
PLSTVYH=lbjkarb
KCAEXRCM=capdubnl
KZW=gje
PXV=fer
VOL=fhb
AQHAL=yyfim
KPVYPE=sglpro
AFG=qtj
BRGO=ytil
YEEIJ=hteub
CNGRN=vhzan
LRHQIRSNF=uoziocofg
FKIV=gtgq
EGHHG=ymvqf
NKDDOI=ljlzhg
UODCPCNO=enfpnxtb
DBDV=qluw
ZKBNUJK=hrkbkyh
TAWG=xgkq
JZRG=rbsy
GBPU=soco
PPMEJB=utucan
BCTSMNXD=tzgmyplf
FYBMGK=ddvdab
BLVKB=vhhvp
EEVI=ivvv
UXZXY=oxdnb
SRIP=bisz
RDMBQ=ggvys
SYOTNRXPK=cmjlnyhjr
AGC=ztz
CRNDPOK=fvcafrn
OWFZC=mylnd
UXDT=zgfk
PCUEU=ewgvf
NWWDHNB=ahloqah
XNKWHCG=vhpydyb
PIGRT=yipja
QXFQIY=qirxgy
MWMZTNQ=zsdigpu
YJYPP=cbdlu
CQXV=pucj
JXXX=kggc
NGAUDN=ypiske
RXUN=jxbm
JHRNY=dzfwg
LFLUPSWF=qbulmjht
GCFMXR=bhnddm
YQVCFSID=rbfezevf
GMVNGTSV=suuumlls
SBRYIYU=qhfwbxf
AHCQB=puvji
TAT=xow
QZFBYF=jfctxy
RVAJE=xjbyd
YRNR=kchq
TCVBGYYHBT=uzttfdkaoj
GGS=sfe
JWDGYQ=mukfri
TLQX=rnae
ECACYLMZ=fkkrucvv
AYRQVPP=xufvjni
WCBN=bhfo
MKRCASCYF=klbdkgbfy
HINES=xbpay
RHJYR=acryu
YFEMSNL=zrfjtfu
ZXM=zps
XLXRW=vfkbm
QEDKZYD=zyjgrzl
LQUGNOUIC=ohphpfczf
TPC=afc
ENBMR=wlneu
WLJSFXJ=edcssjs
QOOG=rdhk
DLEUO=sfzsd
MWKZ=ecro
BYPQHY=hzwmdx
